When	Khi
Brother	Anh/em trai
Pass	Vượt qua
Valley	Thung lũng
And	Và
Dark	Bóng tối
Write	Viết
Table	Bàn
Leg	Chân
Life	Đời
See	Nhìn
Not	Không
Save	Lưu
Eye	Mắt
Dry	Khô
We	Chúng ta
Ill	Ốm
Wrong	Sai
Or	Hoặc
Right	Phải